R 1280 720
NO ./textures/northwall_64x64.xpm
SO ./textures/southwall_64x64.xpm
WE ./textures/westwall_64x64.xpm
EA ./textures/eastwall_64x64.xpm

S ./textures/sprite_64x64.xpm
F 66,66,66
C 33,33,33

        1111111111111111111111111
        1000000000110000000000001
        1011000001110000002000001
        1001000000000000000000001
111111111011000001110000000000001
100000000011000001110111111111111
11110111111111011100000022221    
11110111111111011101010012221    
11000000110101011100000012201    
10002000000000001100000010201    
10000000000000001101010010001    
1100000111010101111101111000111  
11110111 1110101 101111010N01    
11111111 1111111 111111111111    
